####################
#.........#...##..F#
#..#.##.*..*..##...#
##.#.#..##....#....#
#....##...###....#*#
#*.#....#.#........#
#..##..##...#..###.#
##.....#......*...##
##..###..#.*..#..###
##......#.......*.##
##..#......####...##
#..#*......#.*..#..#
#.....#...##....##.#
#.......*..#.##...*#
#.*#.#*....#....*#.#
#..#.#..##.#....#..#
#..######..*.##...##
#.*#...#......###..#
#S...#.....##......#
####################