####################
#**...#*#...##.*..F#
#*.*.*..###.#..#.**#
##..*#......**#*..##
#*#.#.#*#..*.#.*.###
##.#..####.*#*##.*.#
##.#*#.##.#*......##
#..*#.*.#.***......#
##**##**#.#...#.*..#
#*.#.#*.#...##..*..#
###*..*##...#.#.#..#
#.*#*.#....#*###*.##
##......#..#.#...#*#
#*.#.**#*.#*..#.*.*#
##...###*..**..##*.#
#*.*..#...#*.#.**..#
#..#*.#***#.*....#.#
##.##*##*#**...##.*#
#.....**..#..####*.#
####################