####################
#............###..F#
#....##......#.....#
###...###....#..#..#
#.......###.....#..#
###..#..........#..#
#....######.....#..#
#..................#
##..####.......#...#
#...#....###...#####
#...#....#.........#
#..###.......###...#
#..#....#....#.....#
#..#...#...###.....#
#..#...#...#.......#
#......##.......#..#
###........#....####
#....##..###.......#
#S....#........#####
####################