####################
#*...**##.##..*...F#
#...###..***.*#.*#.#
#***#**.#.#*..#*.*.#
##.#*...##..*.##.*.#
#**###..#.#.*.#....#
#***.***#....#**.*.#
#....**.#.#*.*...#*#
#..###*.*...#.#*.*##
#.#**.**.*###.*..*##
###*#*#.#*.......###
#.****#*.#*..##...*#
###.**...#..#***.###
#**.*.*##..##.*#.**#
##..#.###...#*...*.#
#**#*.###..**.#.*.*#
#*....#*....*#.#*.*#
##..#......#.#**.###
#S.###.*##...*.#*###
####################